##########
#D CCCC D#
# C#C#C# #
#CCCCCCCC#
#C# ICICC#
#CC CICCC#
#CC#C#C#C#
# CCCCCC #
#D CCCC D#
##########
