##########
#  CCCC  #
# C#C#C# #
#CCCCCCCC#
#C# ICICC#
#CC CICCC#
#CC#I#C#C#
# CCICCC #
#  CCCC  #
##########
