##########
#D CCCC D#
# CCC CC #
#CCCCCCCC#
#CC  CCCC#
#CC C CCC#
#CCCC CCC#
# CCCCCC #
#D CCCC D#
##########