##########
#D CCCC D#
# C#C#C# #
#CCCCCCCC#
#C# #C#CC#
#CC C CCC#
#CC#C#C#C#
# CCCCCC #
#D CCCC D#
##########