################
#D CCCCCCCCCC D#
# CCCCCCCCCCCC #
#CCCCCCCCCCCCCC#
#CCCCCCCCCCCCCC#
#CCCCCCCCCCCCCC#
#CCCCCCCCCCCCCC#
#CCCCCCCCCCCCCC#
#CCCCCCCCCCCCCC#
#CCCCCCCCCCCCCC#
#CCCCCCCCCCCCCC#
#CCCCCCCCCCCCCC#
#CCCCCCCCCCCCCC#
# CCCCCCCCCCCC #
#D CCCCCCCCCC D#
################